’                                                           .   
  2#############################K############################   
   ##‘  2    2   2 2    2   2  ###  2  2   2    2    2    2##   
  2##+#2   2   2    2  2 2   2  2 2  2   2 2   2   2    2  ##   
   ##+#   2  2    2   2   2   2    2    2  2    2    2   2 ##   
  2##+# 2    2  2   2  2 2 2 2  2 2  2 2 2   2    2   2   2##   
   ##+#2   2  2   2                            2   2   2   ## W 
  2##+#  2   2   2   XXXXXXXXXXXXXXXXXXXXXXX  2    2  2   2##@@@
   ##+#2   2  2   2  XXXXXXXXXXXXXXXXXXXXXXX    2   2  2   ##   
  2##+# 2   2  2 2   XXXXXXXXXXXXXXXXXXXXXXX   2  2   2  2 ##   
   ##+#   2 2 2   2  XXXXXX    -+-    XXXXXX  2 2    2  2  ##   
  2##+#2   2   2 2   XXXXXX1   -P-   1XXXXXX  2  2 2   2 2 ##   
   ##+#  2  2  2  2  XXXXXX    -+-    XXXXXX   2  2 2     2##   
  2##+# 2 2  2  2    XXXXXXXXXXXXXXXXXXXXXXX  2   2   2 2  ##   
   ##+#2 2    2   2  XXXXXXXXXXXXXXXXXXXXXXX    2  2   2 2 ##   
  2##+# 2  2  2  2   XXXXXXXXXXXXXXXXXXXXXXX   2    2 2 2  ##   
   ##+#  2  2 2   2                           2  2   2   2 ##   
  2##+#2   2    2   2 2  2  2  2 2  2 2  2  2   2   2  2  2##   
   ##+# 2    2  2  2 2  2   2   2   2  2  2    2    2   2  ##   
  2##3#   2   2   2   2   2   2   2   2 2    2    2   2   2##@@@
   ##T#2   2     2  2  2 2   2 ###   2   2 2  2    2   2   ##222
   #############################S#######################XXX##@@@
                                                          I##LLL
