-------¼--------44---³³³³³³³³³³³³º---º³³³³³³³³³³³------K---¹;-U-
XXXXXXX-XXX-----44---      -----------------    ----#######-;---
--------------71#####       ---------------      #####¹-----;;;;
K------------71###           -------------          #####³##; P 
#17---------71####****        -----------       ****##----‘W;   
##17-------71#####*###         ----K----        ###*##³#####;   
###17-----71######*#             #####            #*## 1   7;   
####17---71#######*;     W    W    W    W    W    :*#######³;   
#####17-71########*#444444444444444444444444444444#*##ñ     ;   
######---#########*#                              #*##444³##;   
#######ä##########U#                              #!##‘     ;   
----------------####                              ######³###;   
----------------##VVVVVVVVVVVVVVVVVVVVVVVVVVVVVVVVVV## •    ;   
----------------##VVVVVVVVVVVVVVVVVVVVVVVVVVVVVVVVVV###³####;   
»ä-------------ò######################################      ;   
5555555555555555#############the#lava#pit#################³#;   
            -------         ------------***********-##+’   C;   
              000            ---»######-###########-####³###;   
                                ------7‘##LL-D-D-D-³##      ;   
                                     ##-###########³#######³;   
                                     ##-7  1   TTT7³##     ‘;   
¼       1 1 1 1 1 1 1 1 1 1 1 1 1 1 1##--#########‘³###³####;   
###this#is#the#first#sideways#level####111111111  äC##•       ‘ 
