T    P  #the#step#of#faith#-----’-~Kñ-------U-----#---D-D-D-D-LL
######----------------------º44444444-------»-K’--#½############
-----------------------------#       ------#####»-#-----³-------
-----------------------------#        -----:------#----³-³------
------###--------------------#        -----:------#--³³---³-----
--------#--------------------#        -----:------#-#------¼----
--------#--------------------#        -----#####--#-#-----------
--------#--------------------#        -----#---;--#-#------¼----
--------#--------------------#        -----#<###--#-#-----------
--------#---------õ---------º#         ----#[#----#-#-----³-----
--K-----#¹########88888888888#         ----#|#----#-#----³--W---
-XXX----#      #             #         ----#"#----#-#-------W---
        #      #             #          ---#-#----#-#---³---W---
        # “    #             #          ----------#-##-³----W---
        #      #             #             ;;;;;- #½K#³-----W---
        #      #             #                 +-+####------W---
        #      #             #                 +-+----³-----W---
    XXXX#      #             #                 +-+---³------W---
         ¹     #             #                 +-+###-----------
       ###     #             #    U            +-+#--------7----
               #             #                 + +#   ##C.!.C## 
               #             #                 + +#   ######### 
VVVVVVVVVVVVVVVVVVVVVVVVVVVVVVVVVVVVVVVVVVVVVVVVVVVVVVVVVVVVVVVV
