LLL##U##@@@@@@@@@@@|000---0000000000000000-0--00000000VVV000Y-0V
```##-##@00000000000000---0000222222220---0000-00000000000--Y-0V
```##K##@@022222222K000---0000-0000000000-0000-0)))))YYYW-W0Y-0V
```##6##@@@222222222000---000U*******00000000000)))0000000000-00
```##6##@@@222222222000---000000000000000000000000222222--000---
```##6##@@0222222222000---(((((((((((((((ñ(((((000222222-C00000-
333##6##@00000000000000---00004444444444444444(0000000000000000-
333##6##3CCC....0---------00022222222222222222(K(---------------
$$$##6##000000000000000---00000000000000000000000000000000000000
   0--00000000000000000---000000000000000000000===============--
 P 00-00+02222222220--------------------------0="===-=--===-==-=
$$$00-00+02222222220-00---0000000000000000000-0==I=-=-==-=-=-==-
 ! 00-00+02222222220-00-Z-0000000000000000000-0=H==-===T==-==--=
00000-00[02222B22220-00---00----03333333CC----0==I==-===-==-====
0--00-00+02222222220-00---00-0000000000000000-0===--==-==-==--==
-0000-00+02222222220-00---00-0000000000000000-0==-===-=-=-====-=
00000-00+02222222220W00---00-----0--------000-0=-==--==-=-=--=T=
0--00-00000000000000000---000000000001110-000-0==T-===-===-==-==
00000-00000000000000000---000000000001110-00000=======-=========
--000----------------- ---0WWWWWWWWK01110-000-000000000000000000
00000-00000000000000000---000-00000001110-000K--<000OO000OOOOOó*
--000-000000~~~0000000#---#00-00000000000-000000000000OOOO000000
00C000000********3000##VVV##0-------------00000000bouldervilleÃ0
